{
    "remark":"坐标(x, y)",
    "up_index":[1, 1],
    "down_index":[6, 14],
    "map":[
        [0, 0, 0, 0, 0, 0, 0, 0, 0, 0, 0, 0, 0, 0, 0],
        [0, 4, 1, 102, 103, 102, 1, 1, 1, 1, 1, 1, 1, 1, 0],
        [0, 0, 0, 0, 0, 0, 0, 0, 0, 0, 0, 0, 0, 1, 0],
        [0, 0, 0, 0, 0, 0, 0, 0, 0, 0, 0, 0, 0, 1, 0],
        [0, 0, 0, 0, 0, 0, 0, 0, 0, 0, 0, 0, 0, 1, 0],
        [0, 1, 1, 1, 3002, 1, 0, 0, 0, 0, 0, 0, 0, 1, 0],
        [0, 1, 106, 1, 0, 1, 0, 0, 0, 0, 0, 0, 0, 1, 0],
        [0, 0, 3002, 0, 0, 1, 0, 0, 0, 0, 0, 0, 0, 1, 0],
        [0, 1, 1, 1, 0, 1, 0, 0, 0, 0, 0, 0, 0, 1, 0],
        [0, 1, 108, 1, 0, 1, 23, 0, 0, 0, 0, 0, 0, 1, 0],
        [0, 0, 3002, 0, 0, 1, 1, 1, 1, 1, 1, 1, 1, 1, 0],
        [0, 1, 1, 1, 0, 0, 3002, 0, 24, 0, 0, 0, 3002, 0, 0],
        [0, 1, 1, 1, 0, 1, 1, 1, 0, 1, 1, 1, 1, 1, 0],
        [0, 1, 1, 1, 0, 1, 1, 1, 0, 1, 1, 102, 1, 102, 0],
        [0, 0, 0, 0, 0, 0, 3, 0, 0, 0, 0, 0, 0, 0, 0]
    ]
}